here	adverb
there	adverb
who	question
what	question
where	question
when	question
how	question
huh	question
all	quantifier
many	quantifier
some	quantifier
few	quantifier
little	adjective
other	adjective
one	numeral
two	numeral
three	numeral
four	numeral
five	numeral
big	adjective
long	adjective
wide	adjective
thick	adjective
heavy	adjective
small	adjective
short	adjective
narrow	adjective
thin	adjective
woman	noun
man	noun
person	noun
child	noun
wife	noun
husband	noun
mother	noun
father	noun
animal	noun
fish	noun
bird	noun
dog	noun
louse	noun
snake	noun
worm	noun
tree	noun
forest	noun
stick	noun
fruit	noun
seed	noun
leaf	noun
root	noun
bark	noun
flower	noun
grass	noun
rope	noun
skin	noun
meat	noun
blood	noun
bone	noun
fat	noun
egg	noun
horn	noun
tail	noun
feather	noun
hair	noun
head	noun
ear	noun
eye	noun
nose	noun
mouth	noun
tooth	noun
tongue	noun
fingernail	noun
foot	noun
leg	noun
knee	noun
hand	noun
wing	noun
belly	noun
guts	noun
neck	noun
back	noun
breast	noun
heart	noun
liver	noun
drink	verb,transitive
eat	verb,transitive
bite	verb,transitive
suck	verb,transitive
spit	verb,transitive
vomit	verb,transitive
blow	verb,transitive
breathe	verb,intransitive
laugh	verb,intransitive
see	verb,transitive
hear	verb,transitive
know	verb,transitive
think	verb,transitive
smell	verb,transitive
fear	noun
sleep	verb,instransitive
live	verb,intransitive
die	verb,intransitive
kill	verb,transitive
fight	verb,transitive
hunt	verb,transitive
hit	verb,transitive
cut	verb,transitive
split	verb,transitive
stab	verb,transitive
scratch	verb,transitive
dig	verb,transitive
swim	verb,intransitive
fly	verb,intransitive
walk	verb,intransitive
come	verb,intransitive
lie	verb,intransitive
sit	verb,intransitive
stand	verb,intransitive
turn	verb,intransitive
fall	verb,intransitive
give	verb,transitive
hold	verb,transitive
squeeze	verb,transitive
rub	verb,transitive
wash	verb,transitive
wipe	verb,transitive
pull	verb,transitive
push	verb,transitive
throw	verb,transitive
tie	verb,transitive
sew	verb,transitive
count	verb,transitive
say	verb,transitive
sing	verb,transitive
play	verb,transitive
float	verb,intransitive
flow	verb,intransitive
freeze	verb,intransitive
swell	verb,intransitive
sun	noun
moon	noun
star	noun
water	noun
rain	noun
river	noun
lake	noun
sea	noun
salt	noun
stone	noun
sand	noun
dust	noun
earth	noun
cloud	noun
fog	noun
sky	noun
wind	noun
snow	noun
ice	noun
smoke	noun
fire	noun
ash	noun
burn	verb,transitive
path	noun
road	noun
mountain	noun
red	adjective
green	adjective
yellow	adjective
white	adjective
black	adjective
night	noun
day	noun
year	noun
hot	adjective
cold	adjective
full	adjective
new	adjective
old	adjective
good	adjective
bad	adjective
rotten	adjective
dirty	adjective
straight	adjective
round	adjective
sharp	adjective
dull	adjective
smooth	adjective
wet	adjective
dry	adjective
correct	adjective
near	adverb
far	adverb
right	adjective
left	adjective
right	adverb
left	adverb
at	preposition
in	preposition
with	preposition
and	conjunction
if	preposition
of	preposition
to	preposition
because	conjunction
name	noun
speak	verb,transitive
language	noun
welcome	polite
hello	expression
sorry	expression
thanks	expression
yes	expression
no	expression
bye	expression
please	expression
quickly	adverb
slowly	adverb
well	adverb
poorly	adverb
game	noun
song	noun
school	noun
learn	verb,transitive
like	verb,transitive
is	verb,transitive
and	conjunction
or	conjunction
lang	noun